1111111111111111111111111111111111111111111111111111111111111111111111111111111111111111111111111111
1000000000000000000000000000000001000001010000000000000000000000000000000000000000000000000000000E01
1011111111111111111111111111111111101010101111111111111111011111111111111111011111111111111111111001
100101010100010000001010001010010010101010100000000000000C010000000000000000000000000000000000001001
10010101010111011111101010101001001C1010101111111111111111111111111111111111111111111111111111111101
1001010101C00101010010101010100100101010001000000000000000000000C0000000C0000000000000000CC00C001001
10010101000001000000101010101001C0111011101111111110111111111111111111111111111111111110110000000001
1C01010101000101010010001010100100100010100000000000C00000000000C00000000000000000010000010000001001
1001010101000101010010101010100100100000101111111111111111111111111111111111111111111111111101111001
1001C0010100010101001010101010010011101110100000000000000000000000000000000000000001000000C000001001
10010101C100000101C01C101010100100100000101111111111111111111111111011111110111111111111011111111001
1001C1010100010111001010101010010C1010111C10000000000C0C000000000000C0000100000000C00C000C1000001C01
1CC111C101101101010010101010100100101000101C00000000000C0000000000000000010C000000010000000000001001
1001010101C001000100101C1010100100111111111111111111111111111111111101111111111111111111111111111111
10010101010001010100101010101001001001010010100100010101010101000C0000C00000010000C00010010000000001
1001010101101101C10C10101010100100100101001000010000010100010100000000000000010C0C000010011111101111
10010C0101000101010010101010100100100101001110111111010101010111111111111111011101111110000000000001
1001010101C001111101101110101001001001C10010000100C0000001010100000000000000000101000010111111111111
1C01010101000101C00010001C10000000101101C01011111011110101C00000000100000000010001C00C10000000C00001
1001010101000101000000101000100100100101001001010001011101111111111101111111110100000000011111111011
100101010100010111C1111010101CC100100001001011011C11010100000100000000000000010111101110010100000001
10010101010001000000100010101011111001010010010000010101010101C00001000C0000010100000010010000000C01
100001011111011111111111101C10C10010010000100C01011101010101C111111111111111111101111111111111111101
100101010010010010100010101010010010010100100101C0000100010101C000000000000000000000C010000010000001
1C01010100100100101010101010100100100101001111111101111111111101111111111111111111111111111011101111
1001010100100101101010101010100100110111111000000000000000C00100000000000000000000000010000000000001
100101010010C100101110101010100100100C01001C11111111111111111101111111111111111111111111111111111111
100101010C000100001000101C101001001001010010001010100010010101000000000C0000000000000000000000000001
10C101010010010010100000101010010010010100101010001011100101C111111111110111111111111111111111111111
1001010100100110111101111010100100100101001011101110001C0101010010100C00000010000000C0C0000000000C01
1001010100100100101000001C10100000100101001000101C1011101101C100101011101111111111111101111111110111
100101010010C0000010111010101001C01111010010101000100010000101C0101001000000000000000000100000000001
1001010100100101111C00101011110111100101001011111010100001010100101111111011111111111011111111111111
10C1010100100100001011101010100000100101001000000010101001010100101001010010100100101010100001010101
1C01010111110100100C10101010000000100101001111110111111101010100101C01C10000100100100010C000010100C1
1101011100100100101010101011111111100101001001C100101010C1C10100101001010111100100101110101111011101
1001010100000100101000101000000000100101001001000010101001000100101001010010100100100010100000010001
10010101111111111111111111111011111001010010C101C01010100101C1C0001001010010100100111010111111110101
1001010101000100100000001010000000100101001000010010101001010100101001010010100100100010010100010101
10010101011011001111110110111010111C010100100101001010100101010010100101001010010111011C010101010101
100101010000000000000000101000100010010100110101C0001010C1010100101001010000100100100010010101C10101
100101010110111011101111101011110110010100100101001010100101010010100101001010010010001001010101C101
1001010101C00100100010101010101000100101001101110110101001010100101001C11110100100110110010101010101
10010101010001001CC00C001010101110100101C01001010C100010010101001010010100C010C100100010010001010101
1001010101000100101110101010101000100101001001010010101001010100101001010000100100100010010101000101
10010101010001001000101C1C1000100010010100100101001010100101010010000101000010010011011C010101010101
1001010101000100110111111010101101100101000C0101001011100101010010110101000010010010001C111101010101
10010101010001001P0000101010101000100101C0100001001010100101010010100001000010010010001C000101010101
1001010101000100110110100010101000100001001001010010101C01C1010010100101C00010010C100000010101010101
100101010100010010001C00101010100010010000100101001C10100101011110101111110110010010001001C101010101
100101010100010010001C1110101010001001010010010100100010010101001010100100C010000000C010010101010101
100101010100C1001000101010101110001001010010010100101010010101001010100101001C0100100010010101010101
10010101111011001000101010100010001001010010010100101010010101001C1010011110100100101110010001010101
10C1010100000100100010001010001000100101001001010010111C110101001010100101001001C010001001C10101C101
1001010111110111111111111C10001000100101001C01010010101001010100101010010100111110111111110111110111
1C01010100100100000000001010001000100101001001010010101C0101010010101001010010010001C010100101010101
1001010100100101111111111010001000100101001001010010101001010100101000010100100101110C10000101010101
1001010100100100010010101010001000100101001001010010101C010101C0101010010100100100010010100101010101
100101010000010101001000101000100010C1010C1001010010001001010100101010010100100110110011110101010101
1001010100100111C1001011101C0C1000100101001001010010101001010100101010010100100000C10010000001010101
100101010010010101000C1010100010001001C100100101001010100101010010111011010010010001C011101111C10101
1C0101010C1001010100100010100010000001010010010100101000010101001010100101001001011100100001C1010101
100101010111010101001010101C001000100101001001010010101001010100101010C1010010010001001110110001C101
1001C10100100101010011101010001000100101001001010010101001C10100101010010100100100010010000001010101
1001010100100101010010001010001000100101001011110010101001010100101010010100100100010010100101010101
1C010101001001010100100010100010001001010010010100101010C1C101001010100101C0100100010011111111010101
10C10101001001010100110110100010001001010010010100101010010101001C1010010100100101111010010001010101
10010101001001010100100010100011101001010C1000010010101001C10100101010010100100101010010010101010101
10010101001C0101C10010001C10001000100101001111111011111111110100101010C1010010010101001CC10101010101
1C01010C001001010100100010110111111C010100100C1000000101010101C0101010010100100101010010010101010101
1001010100100101010010001010010C1010010100100000000001010101010C101C10010100100101C10010011101010101
1001010100100101000C1000101001000C100101C0111111110111000101010010101001010010010001001001C001010101
1001010100100001010C1000101001001C10010100100010000001011101010010101C010100100101000010000101010001
10010101001C01010100100010100101101001010011101111110101010C01001010100101001001C1010011011111C11101
10010001001001000101110110100100101001010010000000C0000001C101001C1010010000100101110010000101010101
1001010100100101010C100010100000101001010C1111111111110111110100001010010100100100010010010100010101
1001010100100101010011011010010010100101001000CC0010010101010100101010010100100101010010010001010001
1001010100100101C1001000101001001010010100101111101000010100C100101010000100111101111111111111111111
10C101010010010101C01000101101111110010100100000101001010101C100101000010100100000001010000000C00001
1001010100100101010010001010010100100101001101111110110101010100101010010100111101111010111111011111
100101010C10010101001C00100000C100100101001000C00C00010001010100101010010100100C00000010101000000001
10010101001001010100100010100101011001010010111111100101010101001010100101001111010110001C1111111011
1001010100100101C1001000101C0100001001C10010000000100101010101001C1010010100100001001C100010C0000001
1111111111111111111111111111111101111111111111111111111111111110111111111111111111111111111111111111
101000000100000C000000000000000100100001000010C00C000000000000000001000000000000000000000C0000000001
1011011101000000000000000000000100101111011110111111111101111111111111101111111111111111111111111111
10000001011111111111111111110111C1100000000010100000C0000000000000000000000000C000000000000000000001
111111011100000000000C10000000C000110111110110111111111111111111111111111111111111111111111111111111
100000010111111111110111111110110010C001000000100000000000000000000000C00000000000000000000000000001
1000000001000C00C0000000C0000001001001C101111000000000000000000000000000000000C00C000C0000000C001001
1110111111111111111011111111111111101111000010111111111111111111111111111111111111111111111111111101
1000000001000C0C0000000101000000001000C1110110100C0000000000000C0000000000000000000000C000000C000001
1111101111000C00000000010101000000100101C00010100C0000C000000000000000000000000000000000000000001001
1010000101111111101111110101111111111111101111111111111111111111111111111111111111111111111111111111
1010100101000000000000000100000000101000C0000000C0C0000000000000000000000000000000000000C00000000101
101C1C000101111111111111111111101110000000001C00C000000000000000000000000000000000000000000000000101
1000101111000000000000000000000000101111111111111111111111111111111111111111111111011111111111111101
101010C1000100010000000C0101110111100000000010000000000000000000000000000000000000000000000C00000001
1010100001010001C0C0000C01010000001010000000100000C0000000000000000000000000C0000000000C000C00000101
1111111111111111111111111111111111111111111111111111111111111111111111111111111111111111111111111111