1111111111111111111111111111111111111111
10000C000000000000000000000C000000100001
10000000000000000000000000000C0000100001
111111111111111111111111111111101111C111
1010000000C1010000100000P000000000100101
100000000000010100100000000000000C00C001
101000000001000100000C00000000000010C101
11111111111111111111111111111111011111C1
1000000001010100010010100000000000100101
11111111010001C10100100000C0010000100001
1EC0000000010001000000100000010000100101
1111111111111111111111111111111111111111