11111111111111111111
1000C0000C0000000001
10111111111110110101
1000100000000001C101
11111111111111011111
10001000000000000001
11011011111111110101
1P000000000000010101
1E00100000C000010101
11111111111111111111
